Month,Department,Category,Budget_Allocated,Actual_Spent,Variance
2021-01,HR,Salaries,35795,26655,-9140
2021-02,HR,Salaries,96820,108938,12118
2021-03,HR,Salaries,26265,33115,6850
2021-04,HR,Salaries,57194,69156,11962
2021-05,HR,Salaries,64131,70154,6023
2021-06,HR,Salaries,61090,52775,-8315
2021-07,HR,Salaries,84820,75589,-9231
2021-08,HR,Salaries,79735,93068,13333
2021-09,HR,Salaries,87969,83280,-4689
2021-10,HR,Salaries,73707,83476,9769
2021-11,HR,Salaries,48693,45089,-3604
2021-12,HR,Salaries,45658,54600,8942
2022-01,HR,Salaries,38431,31178,-7253
2022-02,HR,Salaries,79150,69339,-9811
2022-03,HR,Salaries,55773,66815,11042
2022-04,HR,Salaries,87435,101553,14118
2022-05,HR,Salaries,86803,94715,7912
2022-06,HR,Salaries,31394,24950,-6444
2022-07,HR,Salaries,23890,22728,-1162
2022-08,HR,Salaries,30627,29419,-1208
2022-09,HR,Salaries,93969,94202,233
2022-10,HR,Salaries,96552,110449,13897
2022-11,HR,Salaries,88148,101573,13425
2022-12,HR,Salaries,43483,49270,5787
2023-01,HR,Salaries,37159,39365,2206
2023-02,HR,Salaries,55920,47505,-8415
2023-03,HR,Salaries,89479,103418,13939
2023-04,HR,Salaries,39457,30478,-8979
2023-05,HR,Salaries,97189,97994,805
2023-06,HR,Salaries,98953,109180,10227
2023-07,HR,Salaries,60757,60449,-308
2023-08,HR,Salaries,65758,62631,-3127
2023-09,HR,Salaries,91211,81372,-9839
2023-10,HR,Salaries,57065,48060,-9005
2023-11,HR,Salaries,52606,54140,1534
2023-12,HR,Salaries,60397,51413,-8984
2024-01,HR,Salaries,75591,89867,14276
2024-02,HR,Salaries,43247,57547,14300
2024-03,HR,Salaries,94065,101327,7262
2024-04,HR,Salaries,29268,40539,11271
2024-05,HR,Salaries,32185,43428,11243
2024-06,HR,Salaries,59099,57670,-1429
2024-07,HR,Salaries,58044,66490,8446
2024-08,HR,Salaries,81228,87676,6448
2024-09,HR,Salaries,68984,66990,-1994
2024-10,HR,Salaries,22568,34415,11847
2024-11,HR,Salaries,82592,74619,-7973
2024-12,HR,Salaries,22695,28117,5422
2021-01,HR,Software,25258,37260,12002
2021-02,HR,Software,59504,49895,-9609
2021-03,HR,Software,33986,36652,2666
2021-04,HR,Software,58660,52221,-6439
2021-05,HR,Software,46854,43038,-3816
2021-06,HR,Software,72251,84913,12662
2021-07,HR,Software,28392,31459,3067
2021-08,HR,Software,72256,85855,13599
2021-09,HR,Software,55222,57059,1837
2021-10,HR,Software,99575,108690,9115
2021-11,HR,Software,83335,84300,965
2021-12,HR,Software,44538,44300,-238
2022-01,HR,Software,90592,95540,4948
2022-02,HR,Software,28110,31883,3773
2022-03,HR,Software,47266,57490,10224
2022-04,HR,Software,26910,29595,2685
2022-05,HR,Software,20206,31724,11518
2022-06,HR,Software,43419,51287,7868
2022-07,HR,Software,70015,79189,9174
2022-08,HR,Software,74268,76651,2383
2022-09,HR,Software,38141,42961,4820
2022-10,HR,Software,91910,105186,13276
2022-11,HR,Software,87214,96840,9626
2022-12,HR,Software,53827,66879,13052
2023-01,HR,Software,82623,88821,6198
2023-02,HR,Software,95450,104991,9541
2023-03,HR,Software,42299,43116,817
2023-04,HR,Software,84044,83833,-211
2023-05,HR,Software,69080,70332,1252
2023-06,HR,Software,22693,26624,3931
2023-07,HR,Software,89163,95320,6157
2023-08,HR,Software,62941,74775,11834
2023-09,HR,Software,38047,38277,230
2023-10,HR,Software,35707,47683,11976
2023-11,HR,Software,64262,78038,13776
2023-12,HR,Software,50080,41386,-8694
2024-01,HR,Software,81373,78149,-3224
2024-02,HR,Software,75016,74490,-526
2024-03,HR,Software,78053,90012,11959
2024-04,HR,Software,25530,36327,10797
2024-05,HR,Software,23748,27293,3545
2024-06,HR,Software,86199,78197,-8002
2024-07,HR,Software,93530,101409,7879
2024-08,HR,Software,88840,98987,10147
2024-09,HR,Software,74384,82621,8237
2024-10,HR,Software,66576,63161,-3415
2024-11,HR,Software,82003,89678,7675
2024-12,HR,Software,72733,74382,1649
2021-01,HR,Travel,43664,35300,-8364
2021-02,HR,Travel,46736,41473,-5263
2021-03,HR,Travel,20854,35402,14548
2021-04,HR,Travel,58623,56015,-2608
2021-05,HR,Travel,75680,79629,3949
2021-06,HR,Travel,70859,66650,-4209
2021-07,HR,Travel,46309,58228,11919
2021-08,HR,Travel,83734,78665,-5069
2021-09,HR,Travel,72662,62864,-9798
2021-10,HR,Travel,32688,27077,-5611
2021-11,HR,Travel,87863,85867,-1996
2021-12,HR,Travel,72083,69860,-2223
2022-01,HR,Travel,85733,99242,13509
2022-02,HR,Travel,54698,56472,1774
2022-03,HR,Travel,42671,42010,-661
2022-04,HR,Travel,71663,77371,5708
2022-05,HR,Travel,69811,62622,-7189
2022-06,HR,Travel,76250,80493,4243
2022-07,HR,Travel,92082,84068,-8014
2022-08,HR,Travel,31411,24322,-7089
2022-09,HR,Travel,87270,95497,8227
2022-10,HR,Travel,28680,38040,9360
2022-11,HR,Travel,91295,104373,13078
2022-12,HR,Travel,31111,25847,-5264
2023-01,HR,Travel,21802,19957,-1845
2023-02,HR,Travel,93656,90272,-3384
2023-03,HR,Travel,67254,79172,11918
2023-04,HR,Travel,80713,87359,6646
2023-05,HR,Travel,66843,79514,12671
2023-06,HR,Travel,36371,38206,1835
2023-07,HR,Travel,22049,17472,-4577
2023-08,HR,Travel,40932,50424,9492
2023-09,HR,Travel,49855,47013,-2842
2023-10,HR,Travel,63016,60416,-2600
2023-11,HR,Travel,62642,67793,5151
2023-12,HR,Travel,71407,62561,-8846
2024-01,HR,Travel,24499,20794,-3705
2024-02,HR,Travel,79040,81223,2183
2024-03,HR,Travel,49299,52173,2874
2024-04,HR,Travel,52711,48250,-4461
2024-05,HR,Travel,73351,88180,14829
2024-06,HR,Travel,68354,60911,-7443
2024-07,HR,Travel,58360,64842,6482
2024-08,HR,Travel,22200,26372,4172
2024-09,HR,Travel,88497,92704,4207
2024-10,HR,Travel,41357,52174,10817
2024-11,HR,Travel,97505,90374,-7131
2024-12,HR,Travel,81135,88475,7340
2021-01,HR,Training,58467,71795,13328
2021-02,HR,Training,23987,36386,12399
2021-03,HR,Training,66214,57432,-8782
2021-04,HR,Training,90271,91567,1296
2021-05,HR,Training,90091,89237,-854
2021-06,HR,Training,60818,63575,2757
2021-07,HR,Training,39830,47259,7429
2021-08,HR,Training,26893,34970,8077
2021-09,HR,Training,99909,104474,4565
2021-10,HR,Training,23436,22190,-1246
2021-11,HR,Training,96213,92108,-4105
2021-12,HR,Training,39738,46347,6609
2022-01,HR,Training,68404,79681,11277
2022-02,HR,Training,59790,58941,-849
2022-03,HR,Training,25600,23596,-2004
2022-04,HR,Training,94543,97489,2946
2022-05,HR,Training,76835,71477,-5358
2022-06,HR,Training,93744,107467,13723
2022-07,HR,Training,38589,39305,716
2022-08,HR,Training,56212,56969,757
2022-09,HR,Training,67202,58262,-8940
2022-10,HR,Training,38711,32131,-6580
2022-11,HR,Training,20301,22769,2468
2022-12,HR,Training,86235,97707,11472
2023-01,HR,Training,85726,86218,492
2023-02,HR,Training,26102,33670,7568
2023-03,HR,Training,46641,38457,-8184
2023-04,HR,Training,52745,64983,12238
2023-05,HR,Training,43093,33662,-9431
2023-06,HR,Training,71885,65748,-6137
2023-07,HR,Training,92991,87005,-5986
2023-08,HR,Training,31093,39163,8070
2023-09,HR,Training,55777,69967,14190
2023-10,HR,Training,30729,22138,-8591
2023-11,HR,Training,65017,55801,-9216
2023-12,HR,Training,47751,45847,-1904
2024-01,HR,Training,98069,95412,-2657
2024-02,HR,Training,74748,70549,-4199
2024-03,HR,Training,39190,46111,6921
2024-04,HR,Training,70993,71640,647
2024-05,HR,Training,28716,42071,13355
2024-06,HR,Training,90316,82684,-7632
2024-07,HR,Training,97575,94230,-3345
2024-08,HR,Training,90031,90924,893
2024-09,HR,Training,75766,79169,3403
2024-10,HR,Training,52097,55218,3121
2024-11,HR,Training,30966,21819,-9147
2024-12,HR,Training,72921,79879,6958
2021-01,HR,Supplies,70300,82977,12677
2021-02,HR,Supplies,75609,89502,13893
2021-03,HR,Supplies,51024,50931,-93
2021-04,HR,Supplies,90313,100551,10238
2021-05,HR,Supplies,35338,27829,-7509
2021-06,HR,Supplies,39508,51583,12075
2021-07,HR,Supplies,23051,29030,5979
2021-08,HR,Supplies,74021,64897,-9124
2021-09,HR,Supplies,78335,91746,13411
2021-10,HR,Supplies,52093,46235,-5858
2021-11,HR,Supplies,59734,56813,-2921
2021-12,HR,Supplies,93523,90322,-3201
2022-01,HR,Supplies,37019,40436,3417
2022-02,HR,Supplies,93847,101061,7214
2022-03,HR,Supplies,99634,94811,-4823
2022-04,HR,Supplies,45945,44253,-1692
2022-05,HR,Supplies,25949,35171,9222
2022-06,HR,Supplies,21150,35094,13944
2022-07,HR,Supplies,94740,102788,8048
2022-08,HR,Supplies,86617,93513,6896
2022-09,HR,Supplies,66175,63980,-2195
2022-10,HR,Supplies,25237,32180,6943
2022-11,HR,Supplies,40056,42831,2775
2022-12,HR,Supplies,76556,82800,6244
2023-01,HR,Supplies,23343,26843,3500
2023-02,HR,Supplies,73222,72884,-338
2023-03,HR,Supplies,36964,42089,5125
2023-04,HR,Supplies,79638,77768,-1870
2023-05,HR,Supplies,87215,80721,-6494
2023-06,HR,Supplies,33284,30537,-2747
2023-07,HR,Supplies,81389,80824,-565
2023-08,HR,Supplies,74340,75650,1310
2023-09,HR,Supplies,98832,107357,8525
2023-10,HR,Supplies,98781,99932,1151
2023-11,HR,Supplies,55247,68115,12868
2023-12,HR,Supplies,82752,96557,13805
2024-01,HR,Supplies,79101,73553,-5548
2024-02,HR,Supplies,46646,42527,-4119
2024-03,HR,Supplies,43049,47118,4069
2024-04,HR,Supplies,88385,85775,-2610
2024-05,HR,Supplies,85417,98706,13289
2024-06,HR,Supplies,29823,29030,-793
2024-07,HR,Supplies,29540,35904,6364
2024-08,HR,Supplies,24611,33834,9223
2024-09,HR,Supplies,77679,73557,-4122
2024-10,HR,Supplies,50977,57324,6347
2024-11,HR,Supplies,80890,71741,-9149
2024-12,HR,Supplies,38071,34904,-3167
2021-01,IT,Salaries,31938,24365,-7573
2021-02,IT,Salaries,24000,19052,-4948
2021-03,IT,Salaries,58304,61783,3479
2021-04,IT,Salaries,89449,96899,7450
2021-05,IT,Salaries,40764,41400,636
2021-06,IT,Salaries,58494,51867,-6627
2021-07,IT,Salaries,32161,24243,-7918
2021-08,IT,Salaries,47350,60482,13132
2021-09,IT,Salaries,35305,35122,-183
2021-10,IT,Salaries,96797,87214,-9583
2021-11,IT,Salaries,77458,76266,-1192
2021-12,IT,Salaries,40358,33625,-6733
2022-01,IT,Salaries,58513,59851,1338
2022-02,IT,Salaries,20412,17955,-2457
2022-03,IT,Salaries,53496,67044,13548
2022-04,IT,Salaries,64425,60413,-4012
2022-05,IT,Salaries,38888,31855,-7033
2022-06,IT,Salaries,67295,76465,9170
2022-07,IT,Salaries,37955,33028,-4927
2022-08,IT,Salaries,90640,82783,-7857
2022-09,IT,Salaries,79031,92221,13190
2022-10,IT,Salaries,27357,29400,2043
2022-11,IT,Salaries,56208,66358,10150
2022-12,IT,Salaries,91180,91698,518
2023-01,IT,Salaries,88450,99802,11352
2023-02,IT,Salaries,75069,78653,3584
2023-03,IT,Salaries,34397,33184,-1213
2023-04,IT,Salaries,66959,57687,-9272
2023-05,IT,Salaries,70517,81393,10876
2023-06,IT,Salaries,86234,83420,-2814
2023-07,IT,Salaries,67280,71203,3923
2023-08,IT,Salaries,36779,34179,-2600
2023-09,IT,Salaries,44466,38637,-5829
2023-10,IT,Salaries,89896,82398,-7498
2023-11,IT,Salaries,79163,86264,7101
2023-12,IT,Salaries,71934,83264,11330
2024-01,IT,Salaries,80921,76407,-4514
2024-02,IT,Salaries,28335,39699,11364
2024-03,IT,Salaries,31130,43102,11972
2024-04,IT,Salaries,80566,71733,-8833
2024-05,IT,Salaries,47192,38254,-8938
2024-06,IT,Salaries,41545,53234,11689
2024-07,IT,Salaries,31174,44099,12925
2024-08,IT,Salaries,29348,43062,13714
2024-09,IT,Salaries,58102,57026,-1076
2024-10,IT,Salaries,26801,21647,-5154
2024-11,IT,Salaries,92267,97635,5368
2024-12,IT,Salaries,43625,50962,7337
2021-01,IT,Software,92592,94108,1516
2021-02,IT,Software,64261,55803,-8458
2021-03,IT,Software,41677,45641,3964
2021-04,IT,Software,70343,66656,-3687
2021-05,IT,Software,82856,96178,13322
2021-06,IT,Software,39065,46989,7924
2021-07,IT,Software,74693,78500,3807
2021-08,IT,Software,62348,70097,7749
2021-09,IT,Software,77854,75348,-2506
2021-10,IT,Software,57080,48404,-8676
2021-11,IT,Software,55909,69712,13803
2021-12,IT,Software,39870,31680,-8190
2022-01,IT,Software,92124,101431,9307
2022-02,IT,Software,46790,57360,10570
2022-03,IT,Software,45289,57650,12361
2022-04,IT,Software,35485,37199,1714
2022-05,IT,Software,24748,35981,11233
2022-06,IT,Software,29435,23144,-6291
2022-07,IT,Software,50355,63358,13003
2022-08,IT,Software,77799,80915,3116
2022-09,IT,Software,45470,45046,-424
2022-10,IT,Software,62918,72374,9456
2022-11,IT,Software,59298,59486,188
2022-12,IT,Software,81629,72133,-9496
2023-01,IT,Software,48016,61976,13960
2023-02,IT,Software,53591,60903,7312
2023-03,IT,Software,87641,81268,-6373
2023-04,IT,Software,42700,34552,-8148
2023-05,IT,Software,40559,41562,1003
2023-06,IT,Software,41732,45575,3843
2023-07,IT,Software,91726,99366,7640
2023-08,IT,Software,72528,68173,-4355
2023-09,IT,Software,72638,82606,9968
2023-10,IT,Software,88866,97953,9087
2023-11,IT,Software,61430,75934,14504
2023-12,IT,Software,27114,30437,3323
2024-01,IT,Software,30975,31998,1023
2024-02,IT,Software,41447,56380,14933
2024-03,IT,Software,43959,34626,-9333
2024-04,IT,Software,49703,49040,-663
2024-05,IT,Software,66427,79630,13203
2024-06,IT,Software,81529,75248,-6281
2024-07,IT,Software,51921,42460,-9461
2024-08,IT,Software,47355,42319,-5036
2024-09,IT,Software,24835,34994,10159
2024-10,IT,Software,67605,81091,13486
2024-11,IT,Software,58088,61304,3216
2024-12,IT,Software,75284,89559,14275
2021-01,IT,Travel,55547,62855,7308
2021-02,IT,Travel,47532,39113,-8419
2021-03,IT,Travel,65445,61158,-4287
2021-04,IT,Travel,76178,82817,6639
2021-05,IT,Travel,90340,98562,8222
2021-06,IT,Travel,95672,85681,-9991
2021-07,IT,Travel,78141,91934,13793
2021-08,IT,Travel,76570,71694,-4876
2021-09,IT,Travel,21015,13208,-7807
2021-10,IT,Travel,28415,31965,3550
2021-11,IT,Travel,82292,96125,13833
2021-12,IT,Travel,24158,34467,10309
2022-01,IT,Travel,26970,23908,-3062
2022-02,IT,Travel,66540,76924,10384
2022-03,IT,Travel,38017,38361,344
2022-04,IT,Travel,28702,19086,-9616
2022-05,IT,Travel,20404,18579,-1825
2022-06,IT,Travel,67926,70689,2763
2022-07,IT,Travel,38384,38244,-140
2022-08,IT,Travel,70612,84186,13574
2022-09,IT,Travel,43524,37160,-6364
2022-10,IT,Travel,30916,25725,-5191
2022-11,IT,Travel,52201,62763,10562
2022-12,IT,Travel,33456,38900,5444
2023-01,IT,Travel,76397,89381,12984
2023-02,IT,Travel,58765,50813,-7952
2023-03,IT,Travel,65106,76270,11164
2023-04,IT,Travel,37100,51423,14323
2023-05,IT,Travel,41949,36493,-5456
2023-06,IT,Travel,57744,60519,2775
2023-07,IT,Travel,56187,60617,4430
2023-08,IT,Travel,27239,31728,4489
2023-09,IT,Travel,78017,78374,357
2023-10,IT,Travel,69922,64285,-5637
2023-11,IT,Travel,62944,70405,7461
2023-12,IT,Travel,93963,92543,-1420
2024-01,IT,Travel,44285,39143,-5142
2024-02,IT,Travel,62808,75736,12928
2024-03,IT,Travel,73871,83069,9198
2024-04,IT,Travel,39758,45012,5254
2024-05,IT,Travel,64238,55490,-8748
2024-06,IT,Travel,59764,61937,2173
2024-07,IT,Travel,57441,68355,10914
2024-08,IT,Travel,79494,85275,5781
2024-09,IT,Travel,85215,88266,3051
2024-10,IT,Travel,26949,26470,-479
2024-11,IT,Travel,75393,73410,-1983
2024-12,IT,Travel,26941,40327,13386
2021-01,IT,Training,81886,82095,209
2021-02,IT,Training,73413,87445,14032
2021-03,IT,Training,62318,73817,11499
2021-04,IT,Training,90173,85027,-5146
2021-05,IT,Training,72329,86443,14114
2021-06,IT,Training,63088,71652,8564
2021-07,IT,Training,59811,66332,6521
2021-08,IT,Training,75479,85335,9856
2021-09,IT,Training,39963,52318,12355
2021-10,IT,Training,93477,97865,4388
2021-11,IT,Training,25569,19869,-5700
2021-12,IT,Training,56586,58601,2015
2022-01,IT,Training,65002,73292,8290
2022-02,IT,Training,26254,33398,7144
2022-03,IT,Training,44214,41564,-2650
2022-04,IT,Training,91774,87864,-3910
2022-05,IT,Training,31637,44052,12415
2022-06,IT,Training,44071,46718,2647
2022-07,IT,Training,61240,69511,8271
2022-08,IT,Training,53434,47622,-5812
2022-09,IT,Training,95697,108858,13161
2022-10,IT,Training,31314,45268,13954
2022-11,IT,Training,77108,88616,11508
2022-12,IT,Training,56668,69729,13061
2023-01,IT,Training,99252,96233,-3019
2023-02,IT,Training,36907,45684,8777
2023-03,IT,Training,71745,71905,160
2023-04,IT,Training,43624,56945,13321
2023-05,IT,Training,30488,43062,12574
2023-06,IT,Training,25240,25693,453
2023-07,IT,Training,30478,43355,12877
2023-08,IT,Training,39262,49789,10527
2023-09,IT,Training,72796,67228,-5568
2023-10,IT,Training,84291,87859,3568
2023-11,IT,Training,79399,83577,4178
2023-12,IT,Training,70428,82623,12195
2024-01,IT,Training,20302,27324,7022
2024-02,IT,Training,20055,23068,3013
2024-03,IT,Training,28717,26867,-1850
2024-04,IT,Training,87661,89140,1479
2024-05,IT,Training,36748,33557,-3191
2024-06,IT,Training,24621,29655,5034
2024-07,IT,Training,25126,20248,-4878
2024-08,IT,Training,38030,45332,7302
2024-09,IT,Training,75658,71528,-4130
2024-10,IT,Training,87067,85239,-1828
2024-11,IT,Training,54674,47760,-6914
2024-12,IT,Training,66271,64423,-1848
2021-01,IT,Supplies,58518,61290,2772
2021-02,IT,Supplies,30267,21329,-8938
2021-03,IT,Supplies,70448,66677,-3771
2021-04,IT,Supplies,76793,83302,6509
2021-05,IT,Supplies,67915,62547,-5368
2021-06,IT,Supplies,23596,25071,1475
2021-07,IT,Supplies,26168,25963,-205
2021-08,IT,Supplies,27561,25819,-1742
2021-09,IT,Supplies,46734,43105,-3629
2021-10,IT,Supplies,46069,50438,4369
2021-11,IT,Supplies,32910,30853,-2057
2021-12,IT,Supplies,97735,103463,5728
2022-01,IT,Supplies,43275,40013,-3262
2022-02,IT,Supplies,80004,89127,9123
2022-03,IT,Supplies,74553,80232,5679
2022-04,IT,Supplies,54529,54696,167
2022-05,IT,Supplies,96090,103350,7260
2022-06,IT,Supplies,23812,31656,7844
2022-07,IT,Supplies,47285,55402,8117
2022-08,IT,Supplies,21605,17227,-4378
2022-09,IT,Supplies,92303,93916,1613
2022-10,IT,Supplies,76138,86039,9901
2022-11,IT,Supplies,96125,100043,3918
2022-12,IT,Supplies,47446,50492,3046
2023-01,IT,Supplies,44818,37408,-7410
2023-02,IT,Supplies,24324,25111,787
2023-03,IT,Supplies,29111,24453,-4658
2023-04,IT,Supplies,36389,50262,13873
2023-05,IT,Supplies,61427,65470,4043
2023-06,IT,Supplies,48746,63325,14579
2023-07,IT,Supplies,20117,24034,3917
2023-08,IT,Supplies,33234,28794,-4440
2023-09,IT,Supplies,73441,64287,-9154
2023-10,IT,Supplies,30954,34657,3703
2023-11,IT,Supplies,66514,79214,12700
2023-12,IT,Supplies,26469,25802,-667
2024-01,IT,Supplies,84323,90931,6608
2024-02,IT,Supplies,65587,59795,-5792
2024-03,IT,Supplies,87584,83817,-3767
2024-04,IT,Supplies,98477,101084,2607
2024-05,IT,Supplies,62533,54361,-8172
2024-06,IT,Supplies,21917,32535,10618
2024-07,IT,Supplies,52254,49242,-3012
2024-08,IT,Supplies,67362,77490,10128
2024-09,IT,Supplies,79383,69392,-9991
2024-10,IT,Supplies,29865,22084,-7781
2024-11,IT,Supplies,59809,68253,8444
2024-12,IT,Supplies,25287,16906,-8381
2021-01,Finance,Salaries,28512,19854,-8658
2021-02,Finance,Salaries,83076,83644,568
2021-03,Finance,Salaries,39216,48424,9208
2021-04,Finance,Salaries,99767,93257,-6510
2021-05,Finance,Salaries,62078,60062,-2016
2021-06,Finance,Salaries,32219,22454,-9765
2021-07,Finance,Salaries,62929,54837,-8092
2021-08,Finance,Salaries,28567,22097,-6470
2021-09,Finance,Salaries,90792,99811,9019
2021-10,Finance,Salaries,93698,102642,8944
2021-11,Finance,Salaries,25415,18806,-6609
2021-12,Finance,Salaries,63925,59876,-4049
2022-01,Finance,Salaries,28007,27071,-936
2022-02,Finance,Salaries,78596,91393,12797
2022-03,Finance,Salaries,50523,63848,13325
2022-04,Finance,Salaries,35524,44806,9282
2022-05,Finance,Salaries,43930,34007,-9923
2022-06,Finance,Salaries,40611,47595,6984
2022-07,Finance,Salaries,34060,41509,7449
2022-08,Finance,Salaries,63303,62813,-490
2022-09,Finance,Salaries,49287,46230,-3057
2022-10,Finance,Salaries,31954,29758,-2196
2022-11,Finance,Salaries,92101,88085,-4016
2022-12,Finance,Salaries,38574,37758,-816
2023-01,Finance,Salaries,39096,31288,-7808
2023-02,Finance,Salaries,54016,55262,1246
2023-03,Finance,Salaries,65558,75975,10417
2023-04,Finance,Salaries,38381,32068,-6313
2023-05,Finance,Salaries,24018,25320,1302
2023-06,Finance,Salaries,87506,85895,-1611
2023-07,Finance,Salaries,74917,82503,7586
2023-08,Finance,Salaries,44519,56470,11951
2023-09,Finance,Salaries,76819,82193,5374
2023-10,Finance,Salaries,91324,86732,-4592
2023-11,Finance,Salaries,79379,78825,-554
2023-12,Finance,Salaries,20922,11341,-9581
2024-01,Finance,Salaries,71356,72145,789
2024-02,Finance,Salaries,86656,87916,1260
2024-03,Finance,Salaries,84484,91818,7334
2024-04,Finance,Salaries,22336,17709,-4627
2024-05,Finance,Salaries,87779,96808,9029
2024-06,Finance,Salaries,79201,73813,-5388
2024-07,Finance,Salaries,63872,67301,3429
2024-08,Finance,Salaries,75180,88890,13710
2024-09,Finance,Salaries,49486,45857,-3629
2024-10,Finance,Salaries,91895,89758,-2137
2024-11,Finance,Salaries,40103,44485,4382
2024-12,Finance,Salaries,23756,34365,10609
2021-01,Finance,Software,36478,29152,-7326
2021-02,Finance,Software,59666,59813,147
2021-03,Finance,Software,91315,93613,2298
2021-04,Finance,Software,34153,35264,1111
2021-05,Finance,Software,96325,97722,1397
2021-06,Finance,Software,32999,45549,12550
2021-07,Finance,Software,20814,27543,6729
2021-08,Finance,Software,96077,111015,14938
2021-09,Finance,Software,22443,22900,457
2021-10,Finance,Software,95916,93699,-2217
2021-11,Finance,Software,37368,42696,5328
2021-12,Finance,Software,76942,67769,-9173
2022-01,Finance,Software,47306,57221,9915
2022-02,Finance,Software,59915,54366,-5549
2022-03,Finance,Software,84644,94904,10260
2022-04,Finance,Software,20126,29687,9561
2022-05,Finance,Software,47632,46427,-1205
2022-06,Finance,Software,85310,86951,1641
2022-07,Finance,Software,75176,86669,11493
2022-08,Finance,Software,64327,57695,-6632
2022-09,Finance,Software,23797,28911,5114
2022-10,Finance,Software,33718,25510,-8208
2022-11,Finance,Software,96589,108705,12116
2022-12,Finance,Software,56244,49661,-6583
2023-01,Finance,Software,21645,26400,4755
2023-02,Finance,Software,39256,32328,-6928
2023-03,Finance,Software,73173,67835,-5338
2023-04,Finance,Software,59282,70697,11415
2023-05,Finance,Software,83374,76082,-7292
2023-06,Finance,Software,31694,45190,13496
2023-07,Finance,Software,95060,109837,14777
2023-08,Finance,Software,59224,53436,-5788
2023-09,Finance,Software,33224,31194,-2030
2023-10,Finance,Software,45150,52070,6920
2023-11,Finance,Software,93509,92086,-1423
2023-12,Finance,Software,28070,26736,-1334
2024-01,Finance,Software,77761,90635,12874
2024-02,Finance,Software,56368,53151,-3217
2024-03,Finance,Software,61914,56885,-5029
2024-04,Finance,Software,99026,106615,7589
2024-05,Finance,Software,87526,82825,-4701
2024-06,Finance,Software,65765,75721,9956
2024-07,Finance,Software,66240,78944,12704
2024-08,Finance,Software,57148,51905,-5243
2024-09,Finance,Software,39097,39492,395
2024-10,Finance,Software,36241,31829,-4412
2024-11,Finance,Software,47696,55046,7350
2024-12,Finance,Software,90480,93875,3395
2021-01,Finance,Travel,39816,46888,7072
2021-02,Finance,Travel,72853,87770,14917
2021-03,Finance,Travel,41566,41482,-84
2021-04,Finance,Travel,82823,95911,13088
2021-05,Finance,Travel,40806,40790,-16
2021-06,Finance,Travel,21759,20940,-819
2021-07,Finance,Travel,22482,36924,14442
2021-08,Finance,Travel,53719,45798,-7921
2021-09,Finance,Travel,22717,33625,10908
2021-10,Finance,Travel,62460,77321,14861
2021-11,Finance,Travel,92847,106417,13570
2021-12,Finance,Travel,38449,29217,-9232
2022-01,Finance,Travel,84077,79567,-4510
2022-02,Finance,Travel,68302,64947,-3355
2022-03,Finance,Travel,58000,59485,1485
2022-04,Finance,Travel,58565,69875,11310
2022-05,Finance,Travel,85155,97555,12400
2022-06,Finance,Travel,72487,74829,2342
2022-07,Finance,Travel,60806,66808,6002
2022-08,Finance,Travel,98623,93496,-5127
2022-09,Finance,Travel,95629,108318,12689
2022-10,Finance,Travel,72603,77025,4422
2022-11,Finance,Travel,46399,56245,9846
2022-12,Finance,Travel,96534,108872,12338
2023-01,Finance,Travel,50678,51360,682
2023-02,Finance,Travel,83230,89610,6380
2023-03,Finance,Travel,94055,107660,13605
2023-04,Finance,Travel,51480,61174,9694
2023-05,Finance,Travel,88836,85558,-3278
2023-06,Finance,Travel,59986,74146,14160
2023-07,Finance,Travel,99111,97081,-2030
2023-08,Finance,Travel,54911,66502,11591
2023-09,Finance,Travel,51821,51324,-497
2023-10,Finance,Travel,80535,85684,5149
2023-11,Finance,Travel,32175,43106,10931
2023-12,Finance,Travel,74771,73127,-1644
2024-01,Finance,Travel,86358,93685,7327
2024-02,Finance,Travel,67057,63207,-3850
2024-03,Finance,Travel,24425,30457,6032
2024-04,Finance,Travel,22198,32824,10626
2024-05,Finance,Travel,40079,33531,-6548
2024-06,Finance,Travel,61874,65733,3859
2024-07,Finance,Travel,70460,81021,10561
2024-08,Finance,Travel,28705,28817,112
2024-09,Finance,Travel,43236,55655,12419
2024-10,Finance,Travel,35358,26767,-8591
2024-11,Finance,Travel,96918,107793,10875
2024-12,Finance,Travel,34596,25400,-9196
2021-01,Finance,Training,98757,90036,-8721
2021-02,Finance,Training,83197,86389,3192
2021-03,Finance,Training,82516,79599,-2917
2021-04,Finance,Training,37771,40651,2880
2021-05,Finance,Training,68285,77348,9063
2021-06,Finance,Training,87642,102199,14557
2021-07,Finance,Training,57599,66751,9152
2021-08,Finance,Training,48529,41715,-6814
2021-09,Finance,Training,47856,40429,-7427
2021-10,Finance,Training,98344,90943,-7401
2021-11,Finance,Training,80774,94526,13752
2021-12,Finance,Training,75029,82714,7685
2022-01,Finance,Training,71693,80128,8435
2022-02,Finance,Training,75961,74594,-1367
2022-03,Finance,Training,96908,95904,-1004
2022-04,Finance,Training,76133,71608,-4525
2022-05,Finance,Training,77384,74568,-2816
2022-06,Finance,Training,42180,55705,13525
2022-07,Finance,Training,98411,90033,-8378
2022-08,Finance,Training,68756,66797,-1959
2022-09,Finance,Training,36725,45183,8458
2022-10,Finance,Training,49402,43665,-5737
2022-11,Finance,Training,66828,79348,12520
2022-12,Finance,Training,67924,66570,-1354
2023-01,Finance,Training,79052,80716,1664
2023-02,Finance,Training,55737,48765,-6972
2023-03,Finance,Training,49373,58438,9065
2023-04,Finance,Training,56397,67006,10609
2023-05,Finance,Training,58709,66479,7770
2023-06,Finance,Training,81120,90370,9250
2023-07,Finance,Training,41172,42727,1555
2023-08,Finance,Training,98617,109125,10508
2023-09,Finance,Training,77492,87726,10234
2023-10,Finance,Training,92355,107117,14762
2023-11,Finance,Training,31046,38763,7717
2023-12,Finance,Training,48769,59303,10534
2024-01,Finance,Training,43150,35861,-7289
2024-02,Finance,Training,24853,37449,12596
2024-03,Finance,Training,41792,39507,-2285
2024-04,Finance,Training,94478,99985,5507
2024-05,Finance,Training,87298,93148,5850
2024-06,Finance,Training,32112,45597,13485
2024-07,Finance,Training,44058,46710,2652
2024-08,Finance,Training,58890,49371,-9519
2024-09,Finance,Training,67304,57457,-9847
2024-10,Finance,Training,21524,13644,-7880
2024-11,Finance,Training,35048,27391,-7657
2024-12,Finance,Training,57904,70048,12144
2021-01,Finance,Supplies,54008,44068,-9940
2021-02,Finance,Supplies,94666,102689,8023
2021-03,Finance,Supplies,75337,77649,2312
2021-04,Finance,Supplies,33350,47704,14354
2021-05,Finance,Supplies,65186,56438,-8748
2021-06,Finance,Supplies,95186,105119,9933
2021-07,Finance,Supplies,40581,53974,13393
2021-08,Finance,Supplies,43051,51757,8706
2021-09,Finance,Supplies,89626,86586,-3040
2021-10,Finance,Supplies,55772,67292,11520
2021-11,Finance,Supplies,69481,63121,-6360
2021-12,Finance,Supplies,77134,87625,10491
2022-01,Finance,Supplies,21341,23196,1855
2022-02,Finance,Supplies,20338,16233,-4105
2022-03,Finance,Supplies,32254,41346,9092
2022-04,Finance,Supplies,31344,23094,-8250
2022-05,Finance,Supplies,74756,67177,-7579
2022-06,Finance,Supplies,78053,73372,-4681
2022-07,Finance,Supplies,35896,48889,12993
2022-08,Finance,Supplies,82552,94323,11771
2022-09,Finance,Supplies,97454,107831,10377
2022-10,Finance,Supplies,47935,42808,-5127
2022-11,Finance,Supplies,49711,44517,-5194
2022-12,Finance,Supplies,32182,44479,12297
2023-01,Finance,Supplies,76276,85817,9541
2023-02,Finance,Supplies,64813,59243,-5570
2023-03,Finance,Supplies,28820,42890,14070
2023-04,Finance,Supplies,89768,90890,1122
2023-05,Finance,Supplies,93543,101448,7905
2023-06,Finance,Supplies,61786,53286,-8500
2023-07,Finance,Supplies,26737,20031,-6706
2023-08,Finance,Supplies,74237,83040,8803
2023-09,Finance,Supplies,45510,54936,9426
2023-10,Finance,Supplies,57265,65115,7850
2023-11,Finance,Supplies,86150,97926,11776
2023-12,Finance,Supplies,94910,104517,9607
2024-01,Finance,Supplies,55435,69799,14364
2024-02,Finance,Supplies,98945,105459,6514
2024-03,Finance,Supplies,22983,33645,10662
2024-04,Finance,Supplies,43510,46161,2651
2024-05,Finance,Supplies,60998,75076,14078
2024-06,Finance,Supplies,26640,28419,1779
2024-07,Finance,Supplies,74620,79937,5317
2024-08,Finance,Supplies,27564,33084,5520
2024-09,Finance,Supplies,99273,98596,-677
2024-10,Finance,Supplies,94038,103663,9625
2024-11,Finance,Supplies,86081,80427,-5654
2024-12,Finance,Supplies,49430,49426,-4
2021-01,Marketing,Salaries,47788,53563,5775
2021-02,Marketing,Salaries,33919,27729,-6190
2021-03,Marketing,Salaries,59974,58979,-995
2021-04,Marketing,Salaries,36371,38687,2316
2021-05,Marketing,Salaries,49629,58045,8416
2021-06,Marketing,Salaries,81916,80352,-1564
2021-07,Marketing,Salaries,82187,85171,2984
2021-08,Marketing,Salaries,53039,62934,9895
2021-09,Marketing,Salaries,78606,79222,616
2021-10,Marketing,Salaries,70072,84646,14574
2021-11,Marketing,Salaries,23430,34249,10819
2021-12,Marketing,Salaries,32676,33492,816
2022-01,Marketing,Salaries,52733,62877,10144
2022-02,Marketing,Salaries,22050,23742,1692
2022-03,Marketing,Salaries,53933,68884,14951
2022-04,Marketing,Salaries,52413,44446,-7967
2022-05,Marketing,Salaries,75619,65764,-9855
2022-06,Marketing,Salaries,60600,75157,14557
2022-07,Marketing,Salaries,55400,49894,-5506
2022-08,Marketing,Salaries,94691,95117,426
2022-09,Marketing,Salaries,63001,54829,-8172
2022-10,Marketing,Salaries,65028,64158,-870
2022-11,Marketing,Salaries,57573,48379,-9194
2022-12,Marketing,Salaries,76638,74840,-1798
2023-01,Marketing,Salaries,49757,41625,-8132
2023-02,Marketing,Salaries,68280,82542,14262
2023-03,Marketing,Salaries,82211,94285,12074
2023-04,Marketing,Salaries,76979,83199,6220
2023-05,Marketing,Salaries,58197,57273,-924
2023-06,Marketing,Salaries,84754,78318,-6436
2023-07,Marketing,Salaries,54157,55750,1593
2023-08,Marketing,Salaries,60042,67250,7208
2023-09,Marketing,Salaries,47376,48121,745
2023-10,Marketing,Salaries,75554,79753,4199
2023-11,Marketing,Salaries,70948,69193,-1755
2023-12,Marketing,Salaries,92750,83476,-9274
2024-01,Marketing,Salaries,66600,67962,1362
2024-02,Marketing,Salaries,82483,90780,8297
2024-03,Marketing,Salaries,50448,50554,106
2024-04,Marketing,Salaries,27657,36507,8850
2024-05,Marketing,Salaries,45425,59121,13696
2024-06,Marketing,Salaries,44578,42484,-2094
2024-07,Marketing,Salaries,81413,92673,11260
2024-08,Marketing,Salaries,27287,18179,-9108
2024-09,Marketing,Salaries,95758,90433,-5325
2024-10,Marketing,Salaries,54701,62465,7764
2024-11,Marketing,Salaries,37674,45698,8024
2024-12,Marketing,Salaries,43874,44748,874
2021-01,Marketing,Software,85160,92762,7602
2021-02,Marketing,Software,45931,49705,3774
2021-03,Marketing,Software,62520,69858,7338
2021-04,Marketing,Software,45559,42850,-2709
2021-05,Marketing,Software,53742,47875,-5867
2021-06,Marketing,Software,41754,35726,-6028
2021-07,Marketing,Software,90831,94744,3913
2021-08,Marketing,Software,61873,60101,-1772
2021-09,Marketing,Software,29903,22923,-6980
2021-10,Marketing,Software,61755,72175,10420
2021-11,Marketing,Software,65648,60881,-4767
2021-12,Marketing,Software,29516,34075,4559
2022-01,Marketing,Software,22396,30942,8546
2022-02,Marketing,Software,39129,30720,-8409
2022-03,Marketing,Software,31303,27486,-3817
2022-04,Marketing,Software,27314,36081,8767
2022-05,Marketing,Software,39623,31762,-7861
2022-06,Marketing,Software,85082,93170,8088
2022-07,Marketing,Software,53130,62118,8988
2022-08,Marketing,Software,46292,49773,3481
2022-09,Marketing,Software,89274,81743,-7531
2022-10,Marketing,Software,73947,86481,12534
2022-11,Marketing,Software,83620,89726,6106
2022-12,Marketing,Software,69708,68725,-983
2023-01,Marketing,Software,88344,94714,6370
2023-02,Marketing,Software,74302,79172,4870
2023-03,Marketing,Software,98249,95810,-2439
2023-04,Marketing,Software,22719,35609,12890
2023-05,Marketing,Software,97236,90977,-6259
2023-06,Marketing,Software,62534,56532,-6002
2023-07,Marketing,Software,38787,44864,6077
2023-08,Marketing,Software,77932,68226,-9706
2023-09,Marketing,Software,95713,107440,11727
2023-10,Marketing,Software,80461,80343,-118
2023-11,Marketing,Software,86672,78736,-7936
2023-12,Marketing,Software,51966,48975,-2991
2024-01,Marketing,Software,32987,27530,-5457
2024-02,Marketing,Software,51575,42582,-8993
2024-03,Marketing,Software,90981,91687,706
2024-04,Marketing,Software,67517,69235,1718
2024-05,Marketing,Software,49257,60993,11736
2024-06,Marketing,Software,62207,65488,3281
2024-07,Marketing,Software,81246,72681,-8565
2024-08,Marketing,Software,46660,41744,-4916
2024-09,Marketing,Software,33507,30566,-2941
2024-10,Marketing,Software,65539,73188,7649
2024-11,Marketing,Software,27491,32018,4527
2024-12,Marketing,Software,70192,75051,4859
2021-01,Marketing,Travel,83888,81961,-1927
2021-02,Marketing,Travel,29077,38213,9136
2021-03,Marketing,Travel,40953,42336,1383
2021-04,Marketing,Travel,87889,101710,13821
2021-05,Marketing,Travel,57567,64637,7070
2021-06,Marketing,Travel,44860,56055,11195
2021-07,Marketing,Travel,97475,109205,11730
2021-08,Marketing,Travel,41427,33855,-7572
2021-09,Marketing,Travel,47083,58593,11510
2021-10,Marketing,Travel,77372,78668,1296
2021-11,Marketing,Travel,27813,32227,4414
2021-12,Marketing,Travel,47082,48883,1801
2022-01,Marketing,Travel,31745,34770,3025
2022-02,Marketing,Travel,34288,47938,13650
2022-03,Marketing,Travel,26540,32962,6422
2022-04,Marketing,Travel,88878,87956,-922
2022-05,Marketing,Travel,95932,103414,7482
2022-06,Marketing,Travel,43411,51618,8207
2022-07,Marketing,Travel,80545,84543,3998
2022-08,Marketing,Travel,98797,108336,9539
2022-09,Marketing,Travel,23093,24815,1722
2022-10,Marketing,Travel,42042,52204,10162
2022-11,Marketing,Travel,64413,69496,5083
2022-12,Marketing,Travel,53756,64256,10500
2023-01,Marketing,Travel,59214,65549,6335
2023-02,Marketing,Travel,48602,59165,10563
2023-03,Marketing,Travel,68901,60583,-8318
2023-04,Marketing,Travel,83416,79042,-4374
2023-05,Marketing,Travel,27424,30281,2857
2023-06,Marketing,Travel,39982,41407,1425
2023-07,Marketing,Travel,21980,27502,5522
2023-08,Marketing,Travel,46431,55871,9440
2023-09,Marketing,Travel,46385,41775,-4610
2023-10,Marketing,Travel,43019,51658,8639
2023-11,Marketing,Travel,41563,38136,-3427
2023-12,Marketing,Travel,25776,19452,-6324
2024-01,Marketing,Travel,88916,87627,-1289
2024-02,Marketing,Travel,94318,101752,7434
2024-03,Marketing,Travel,50707,47049,-3658
2024-04,Marketing,Travel,81788,89131,7343
2024-05,Marketing,Travel,58827,57711,-1116
2024-06,Marketing,Travel,25655,27746,2091
2024-07,Marketing,Travel,73625,82955,9330
2024-08,Marketing,Travel,35251,49360,14109
2024-09,Marketing,Travel,20526,13750,-6776
2024-10,Marketing,Travel,67837,69373,1536
2024-11,Marketing,Travel,48541,52088,3547
2024-12,Marketing,Travel,71027,62790,-8237
2021-01,Marketing,Training,28712,24509,-4203
2021-02,Marketing,Training,85455,84663,-792
2021-03,Marketing,Training,25109,38137,13028
2021-04,Marketing,Training,69268,61701,-7567
2021-05,Marketing,Training,74615,81582,6967
2021-06,Marketing,Training,49759,59931,10172
2021-07,Marketing,Training,80112,74279,-5833
2021-08,Marketing,Training,46589,54362,7773
2021-09,Marketing,Training,82046,80403,-1643
2021-10,Marketing,Training,46143,42297,-3846
2021-11,Marketing,Training,41804,40724,-1080
2021-12,Marketing,Training,84288,92715,8427
2022-01,Marketing,Training,40581,50461,9880
2022-02,Marketing,Training,50087,57249,7162
2022-03,Marketing,Training,52981,46743,-6238
2022-04,Marketing,Training,66167,65935,-232
2022-05,Marketing,Training,63408,60139,-3269
2022-06,Marketing,Training,72269,68060,-4209
2022-07,Marketing,Training,94319,97940,3621
2022-08,Marketing,Training,68787,61507,-7280
2022-09,Marketing,Training,94441,93568,-873
2022-10,Marketing,Training,42431,56847,14416
2022-11,Marketing,Training,69153,65521,-3632
2022-12,Marketing,Training,47424,51480,4056
2023-01,Marketing,Training,65004,73337,8333
2023-02,Marketing,Training,76985,84286,7301
2023-03,Marketing,Training,72326,72759,433
2023-04,Marketing,Training,43398,33487,-9911
2023-05,Marketing,Training,70861,71222,361
2023-06,Marketing,Training,88577,78682,-9895
2023-07,Marketing,Training,29078,37357,8279
2023-08,Marketing,Training,91626,106518,14892
2023-09,Marketing,Training,69786,61711,-8075
2023-10,Marketing,Training,46015,36567,-9448
2023-11,Marketing,Training,84881,96648,11767
2023-12,Marketing,Training,46289,39678,-6611
2024-01,Marketing,Training,45683,49312,3629
2024-02,Marketing,Training,81550,96376,14826
2024-03,Marketing,Training,46630,37088,-9542
2024-04,Marketing,Training,66163,56370,-9793
2024-05,Marketing,Training,86435,88088,1653
2024-06,Marketing,Training,47961,54366,6405
2024-07,Marketing,Training,94137,85031,-9106
2024-08,Marketing,Training,76446,87734,11288
2024-09,Marketing,Training,56877,60135,3258
2024-10,Marketing,Training,35313,40662,5349
2024-11,Marketing,Training,92715,93041,326
2024-12,Marketing,Training,21560,25172,3612
2021-01,Marketing,Supplies,46745,56767,10022
2021-02,Marketing,Supplies,72579,67359,-5220
2021-03,Marketing,Supplies,48380,50274,1894
2021-04,Marketing,Supplies,22356,17146,-5210
2021-05,Marketing,Supplies,40049,40230,181
2021-06,Marketing,Supplies,36082,26743,-9339
2021-07,Marketing,Supplies,57412,63123,5711
2021-08,Marketing,Supplies,22920,28922,6002
2021-09,Marketing,Supplies,80315,84340,4025
2021-10,Marketing,Supplies,28946,31678,2732
2021-11,Marketing,Supplies,36309,48771,12462
2021-12,Marketing,Supplies,50027,47032,-2995
2022-01,Marketing,Supplies,79321,70277,-9044
2022-02,Marketing,Supplies,94131,99271,5140
2022-03,Marketing,Supplies,98339,91792,-6547
2022-04,Marketing,Supplies,59443,50398,-9045
2022-05,Marketing,Supplies,59063,64984,5921
2022-06,Marketing,Supplies,24703,21266,-3437
2022-07,Marketing,Supplies,45849,57864,12015
2022-08,Marketing,Supplies,97539,98356,817
2022-09,Marketing,Supplies,46958,48129,1171
2022-10,Marketing,Supplies,65350,67551,2201
2022-11,Marketing,Supplies,49426,57204,7778
2022-12,Marketing,Supplies,65241,64702,-539
2023-01,Marketing,Supplies,68364,58893,-9471
2023-02,Marketing,Supplies,77056,87031,9975
2023-03,Marketing,Supplies,46723,60002,13279
2023-04,Marketing,Supplies,98301,102211,3910
2023-05,Marketing,Supplies,31561,30692,-869
2023-06,Marketing,Supplies,86061,98922,12861
2023-07,Marketing,Supplies,69153,59527,-9626
2023-08,Marketing,Supplies,46916,49113,2197
2023-09,Marketing,Supplies,24648,17013,-7635
2023-10,Marketing,Supplies,70677,62323,-8354
2023-11,Marketing,Supplies,90135,82413,-7722
2023-12,Marketing,Supplies,67064,60219,-6845
2024-01,Marketing,Supplies,89350,92475,3125
2024-02,Marketing,Supplies,81272,95875,14603
2024-03,Marketing,Supplies,87649,98389,10740
2024-04,Marketing,Supplies,33760,45687,11927
2024-05,Marketing,Supplies,81367,83955,2588
2024-06,Marketing,Supplies,72233,74203,1970
2024-07,Marketing,Supplies,53397,60050,6653
2024-08,Marketing,Supplies,96367,92091,-4276
2024-09,Marketing,Supplies,96619,99768,3149
2024-10,Marketing,Supplies,39816,39288,-528
2024-11,Marketing,Supplies,26276,31911,5635
2024-12,Marketing,Supplies,99530,113029,13499
2021-01,Operations,Salaries,91635,91134,-501
2021-02,Operations,Salaries,55946,68382,12436
2021-03,Operations,Salaries,71886,68002,-3884
2021-04,Operations,Salaries,35563,29131,-6432
2021-05,Operations,Salaries,29847,33982,4135
2021-06,Operations,Salaries,87278,95587,8309
2021-07,Operations,Salaries,20619,28277,7658
2021-08,Operations,Salaries,70108,62047,-8061
2021-09,Operations,Salaries,40337,46338,6001
2021-10,Operations,Salaries,86504,91350,4846
2021-11,Operations,Salaries,20281,25641,5360
2021-12,Operations,Salaries,59030,50088,-8942
2022-01,Operations,Salaries,96260,91438,-4822
2022-02,Operations,Salaries,49856,49056,-800
2022-03,Operations,Salaries,84178,75407,-8771
2022-04,Operations,Salaries,45611,56580,10969
2022-05,Operations,Salaries,61235,70359,9124
2022-06,Operations,Salaries,55057,46296,-8761
2022-07,Operations,Salaries,85661,88165,2504
2022-08,Operations,Salaries,81212,86610,5398
2022-09,Operations,Salaries,76503,73141,-3362
2022-10,Operations,Salaries,26570,19819,-6751
2022-11,Operations,Salaries,29110,26705,-2405
2022-12,Operations,Salaries,99141,101256,2115
2023-01,Operations,Salaries,59062,71973,12911
2023-02,Operations,Salaries,52556,55151,2595
2023-03,Operations,Salaries,21969,22954,985
2023-04,Operations,Salaries,24470,38029,13559
2023-05,Operations,Salaries,30225,29781,-444
2023-06,Operations,Salaries,43196,40715,-2481
2023-07,Operations,Salaries,33669,28281,-5388
2023-08,Operations,Salaries,68320,72966,4646
2023-09,Operations,Salaries,35577,48050,12473
2023-10,Operations,Salaries,75409,80913,5504
2023-11,Operations,Salaries,44089,37808,-6281
2023-12,Operations,Salaries,85838,87982,2144
2024-01,Operations,Salaries,70138,70193,55
2024-02,Operations,Salaries,57208,68501,11293
2024-03,Operations,Salaries,50659,43731,-6928
2024-04,Operations,Salaries,51890,55488,3598
2024-05,Operations,Salaries,67055,71020,3965
2024-06,Operations,Salaries,39508,39027,-481
2024-07,Operations,Salaries,98916,100781,1865
2024-08,Operations,Salaries,28125,21416,-6709
2024-09,Operations,Salaries,89569,84674,-4895
2024-10,Operations,Salaries,37087,35220,-1867
2024-11,Operations,Salaries,25704,23552,-2152
2024-12,Operations,Salaries,92460,102672,10212
2021-01,Operations,Software,86024,83138,-2886
2021-02,Operations,Software,45923,51663,5740
2021-03,Operations,Software,49165,40832,-8333
2021-04,Operations,Software,24114,17667,-6447
2021-05,Operations,Software,93297,84297,-9000
2021-06,Operations,Software,45426,53198,7772
2021-07,Operations,Software,23712,15079,-8633
2021-08,Operations,Software,71924,65650,-6274
2021-09,Operations,Software,47723,42529,-5194
2021-10,Operations,Software,29108,31286,2178
2021-11,Operations,Software,55643,51235,-4408
2021-12,Operations,Software,28927,41370,12443
2022-01,Operations,Software,99973,101503,1530
2022-02,Operations,Software,96743,110244,13501
2022-03,Operations,Software,80233,73222,-7011
2022-04,Operations,Software,97576,96794,-782
2022-05,Operations,Software,42612,39083,-3529
2022-06,Operations,Software,55631,56324,693
2022-07,Operations,Software,51348,42525,-8823
2022-08,Operations,Software,24760,14771,-9989
2022-09,Operations,Software,41636,47989,6353
2022-10,Operations,Software,73551,75107,1556
2022-11,Operations,Software,47598,49161,1563
2022-12,Operations,Software,66819,67841,1022
2023-01,Operations,Software,93770,105599,11829
2023-02,Operations,Software,79889,83067,3178
2023-03,Operations,Software,78348,92944,14596
2023-04,Operations,Software,53174,52380,-794
2023-05,Operations,Software,89967,101594,11627
2023-06,Operations,Software,59310,72630,13320
2023-07,Operations,Software,28906,23052,-5854
2023-08,Operations,Software,65379,68455,3076
2023-09,Operations,Software,57650,61763,4113
2023-10,Operations,Software,66413,62425,-3988
2023-11,Operations,Software,70115,67266,-2849
2023-12,Operations,Software,77716,71326,-6390
2024-01,Operations,Software,62652,59546,-3106
2024-02,Operations,Software,33467,47162,13695
2024-03,Operations,Software,74691,74564,-127
2024-04,Operations,Software,32289,34497,2208
2024-05,Operations,Software,63596,76767,13171
2024-06,Operations,Software,64139,70084,5945
2024-07,Operations,Software,49734,46786,-2948
2024-08,Operations,Software,83646,77300,-6346
2024-09,Operations,Software,38743,44343,5600
2024-10,Operations,Software,94172,90613,-3559
2024-11,Operations,Software,44611,56198,11587
2024-12,Operations,Software,32149,23947,-8202
2021-01,Operations,Travel,79189,78789,-400
2021-02,Operations,Travel,41675,37170,-4505
2021-03,Operations,Travel,62668,66341,3673
2021-04,Operations,Travel,96666,109334,12668
2021-05,Operations,Travel,85429,99098,13669
2021-06,Operations,Travel,54068,67321,13253
2021-07,Operations,Travel,29435,38916,9481
2021-08,Operations,Travel,57384,63777,6393
2021-09,Operations,Travel,96153,91905,-4248
2021-10,Operations,Travel,95388,91683,-3705
2021-11,Operations,Travel,54084,66167,12083
2021-12,Operations,Travel,75826,69509,-6317
2022-01,Operations,Travel,27227,20500,-6727
2022-02,Operations,Travel,85681,80691,-4990
2022-03,Operations,Travel,85481,78521,-6960
2022-04,Operations,Travel,84174,91040,6866
2022-05,Operations,Travel,37633,44647,7014
2022-06,Operations,Travel,69104,67957,-1147
2022-07,Operations,Travel,97231,90083,-7148
2022-08,Operations,Travel,36014,27001,-9013
2022-09,Operations,Travel,60390,74101,13711
2022-10,Operations,Travel,77993,77153,-840
2022-11,Operations,Travel,47213,54697,7484
2022-12,Operations,Travel,77784,75205,-2579
2023-01,Operations,Travel,37727,41841,4114
2023-02,Operations,Travel,24358,37522,13164
2023-03,Operations,Travel,51910,64896,12986
2023-04,Operations,Travel,82438,83981,1543
2023-05,Operations,Travel,49371,58104,8733
2023-06,Operations,Travel,80946,76645,-4301
2023-07,Operations,Travel,37625,28750,-8875
2023-08,Operations,Travel,96329,93093,-3236
2023-09,Operations,Travel,74253,76576,2323
2023-10,Operations,Travel,93379,97589,4210
2023-11,Operations,Travel,36456,48312,11856
2023-12,Operations,Travel,30106,25295,-4811
2024-01,Operations,Travel,88008,95099,7091
2024-02,Operations,Travel,92240,85953,-6287
2024-03,Operations,Travel,90587,91343,756
2024-04,Operations,Travel,88011,81621,-6390
2024-05,Operations,Travel,24255,28739,4484
2024-06,Operations,Travel,76549,68284,-8265
2024-07,Operations,Travel,93794,91773,-2021
2024-08,Operations,Travel,65113,62539,-2574
2024-09,Operations,Travel,94069,89318,-4751
2024-10,Operations,Travel,39201,49459,10258
2024-11,Operations,Travel,29686,33795,4109
2024-12,Operations,Travel,73363,64024,-9339
2021-01,Operations,Training,64843,69631,4788
2021-02,Operations,Training,62828,68664,5836
2021-03,Operations,Training,30526,23900,-6626
2021-04,Operations,Training,45592,35799,-9793
2021-05,Operations,Training,88619,92330,3711
2021-06,Operations,Training,40103,37226,-2877
2021-07,Operations,Training,30754,22433,-8321
2021-08,Operations,Training,92982,87425,-5557
2021-09,Operations,Training,75922,81385,5463
2021-10,Operations,Training,49301,61784,12483
2021-11,Operations,Training,82711,81266,-1445
2021-12,Operations,Training,38752,45421,6669
2022-01,Operations,Training,33395,43816,10421
2022-02,Operations,Training,76273,71168,-5105
2022-03,Operations,Training,96559,97258,699
2022-04,Operations,Training,85061,84776,-285
2022-05,Operations,Training,39169,49278,10109
2022-06,Operations,Training,36163,47123,10960
2022-07,Operations,Training,25782,38423,12641
2022-08,Operations,Training,55585,60681,5096
2022-09,Operations,Training,75114,70413,-4701
2022-10,Operations,Training,62685,76643,13958
2022-11,Operations,Training,38073,31340,-6733
2022-12,Operations,Training,84977,79383,-5594
2023-01,Operations,Training,85450,85832,382
2023-02,Operations,Training,24437,19872,-4565
2023-03,Operations,Training,84612,99431,14819
2023-04,Operations,Training,81929,76036,-5893
2023-05,Operations,Training,32329,44261,11932
2023-06,Operations,Training,54594,56015,1421
2023-07,Operations,Training,80631,82896,2265
2023-08,Operations,Training,83133,80762,-2371
2023-09,Operations,Training,93861,103383,9522
2023-10,Operations,Training,51750,49443,-2307
2023-11,Operations,Training,93800,96486,2686
2023-12,Operations,Training,44226,40947,-3279
2024-01,Operations,Training,76154,86763,10609
2024-02,Operations,Training,72130,69503,-2627
2024-03,Operations,Training,75249,81376,6127
2024-04,Operations,Training,25656,24640,-1016
2024-05,Operations,Training,83740,94383,10643
2024-06,Operations,Training,93822,89723,-4099
2024-07,Operations,Training,51552,46469,-5083
2024-08,Operations,Training,93965,98681,4716
2024-09,Operations,Training,31138,23668,-7470
2024-10,Operations,Training,71112,84541,13429
2024-11,Operations,Training,70200,65972,-4228
2024-12,Operations,Training,68244,77157,8913
2021-01,Operations,Supplies,37347,44267,6920
2021-02,Operations,Supplies,51822,55713,3891
2021-03,Operations,Supplies,60108,73671,13563
2021-04,Operations,Supplies,27967,30382,2415
2021-05,Operations,Supplies,31871,33787,1916
2021-06,Operations,Supplies,94270,85115,-9155
2021-07,Operations,Supplies,48179,60340,12161
2021-08,Operations,Supplies,72188,84519,12331
2021-09,Operations,Supplies,55262,57939,2677
2021-10,Operations,Supplies,38268,40598,2330
2021-11,Operations,Supplies,80545,75724,-4821
2021-12,Operations,Supplies,92146,88576,-3570
2022-01,Operations,Supplies,59922,63750,3828
2022-02,Operations,Supplies,62913,59401,-3512
2022-03,Operations,Supplies,75677,69527,-6150
2022-04,Operations,Supplies,69841,73405,3564
2022-05,Operations,Supplies,45032,40110,-4922
2022-06,Operations,Supplies,79474,81642,2168
2022-07,Operations,Supplies,49794,45242,-4552
2022-08,Operations,Supplies,70331,69405,-926
2022-09,Operations,Supplies,26406,41381,14975
2022-10,Operations,Supplies,43291,42091,-1200
2022-11,Operations,Supplies,66851,58489,-8362
2022-12,Operations,Supplies,74823,88135,13312
2023-01,Operations,Supplies,63108,54490,-8618
2023-02,Operations,Supplies,54171,53182,-989
2023-03,Operations,Supplies,88828,87839,-989
2023-04,Operations,Supplies,32411,26928,-5483
2023-05,Operations,Supplies,77009,82431,5422
2023-06,Operations,Supplies,62468,76722,14254
2023-07,Operations,Supplies,91229,81996,-9233
2023-08,Operations,Supplies,71196,76014,4818
2023-09,Operations,Supplies,46715,38264,-8451
2023-10,Operations,Supplies,51174,51130,-44
2023-11,Operations,Supplies,96373,90089,-6284
2023-12,Operations,Supplies,81949,76430,-5519
2024-01,Operations,Supplies,83037,97319,14282
2024-02,Operations,Supplies,26548,35225,8677
2024-03,Operations,Supplies,93294,94194,900
2024-04,Operations,Supplies,43177,57199,14022
2024-05,Operations,Supplies,25542,38282,12740
2024-06,Operations,Supplies,79353,94170,14817
2024-07,Operations,Supplies,76532,82584,6052
2024-08,Operations,Supplies,67076,77728,10652
2024-09,Operations,Supplies,20671,10834,-9837
2024-10,Operations,Supplies,61424,62658,1234
2024-11,Operations,Supplies,73744,68539,-5205
2024-12,Operations,Supplies,30634,25432,-5202
2021-01,R&D,Salaries,42420,51159,8739
2021-02,R&D,Salaries,49300,63645,14345
2021-03,R&D,Salaries,30749,26576,-4173
2021-04,R&D,Salaries,45121,39840,-5281
2021-05,R&D,Salaries,53361,64584,11223
2021-06,R&D,Salaries,92930,96986,4056
2021-07,R&D,Salaries,48380,58257,9877
2021-08,R&D,Salaries,75316,75952,636
2021-09,R&D,Salaries,73352,63368,-9984
2021-10,R&D,Salaries,23191,13583,-9608
2021-11,R&D,Salaries,84641,91596,6955
2021-12,R&D,Salaries,23631,19803,-3828
2022-01,R&D,Salaries,62080,75641,13561
2022-02,R&D,Salaries,40281,54788,14507
2022-03,R&D,Salaries,71431,85266,13835
2022-04,R&D,Salaries,48602,61855,13253
2022-05,R&D,Salaries,71399,84871,13472
2022-06,R&D,Salaries,69230,67310,-1920
2022-07,R&D,Salaries,27099,37409,10310
2022-08,R&D,Salaries,45431,59155,13724
2022-09,R&D,Salaries,67684,64767,-2917
2022-10,R&D,Salaries,83936,96550,12614
2022-11,R&D,Salaries,61991,56931,-5060
2022-12,R&D,Salaries,80920,74376,-6544
2023-01,R&D,Salaries,27788,42771,14983
2023-02,R&D,Salaries,96816,104868,8052
2023-03,R&D,Salaries,36531,49335,12804
2023-04,R&D,Salaries,64857,64999,142
2023-05,R&D,Salaries,68355,68221,-134
2023-06,R&D,Salaries,90067,92753,2686
2023-07,R&D,Salaries,84027,82991,-1036
2023-08,R&D,Salaries,96295,91734,-4561
2023-09,R&D,Salaries,67241,67006,-235
2023-10,R&D,Salaries,48270,51549,3279
2023-11,R&D,Salaries,59279,60762,1483
2023-12,R&D,Salaries,43888,51518,7630
2024-01,R&D,Salaries,81063,91286,10223
2024-02,R&D,Salaries,55144,64537,9393
2024-03,R&D,Salaries,97360,105571,8211
2024-04,R&D,Salaries,26979,26811,-168
2024-05,R&D,Salaries,79560,82064,2504
2024-06,R&D,Salaries,81558,92227,10669
2024-07,R&D,Salaries,26910,41855,14945
2024-08,R&D,Salaries,66857,59053,-7804
2024-09,R&D,Salaries,45227,41205,-4022
2024-10,R&D,Salaries,37153,27933,-9220
2024-11,R&D,Salaries,59071,63757,4686
2024-12,R&D,Salaries,89519,89022,-497
2021-01,R&D,Software,80703,87608,6905
2021-02,R&D,Software,65838,79791,13953
2021-03,R&D,Software,46806,49038,2232
2021-04,R&D,Software,42168,36751,-5417
2021-05,R&D,Software,58714,70039,11325
2021-06,R&D,Software,75419,81796,6377
2021-07,R&D,Software,97425,99700,2275
2021-08,R&D,Software,22461,26752,4291
2021-09,R&D,Software,66804,68239,1435
2021-10,R&D,Software,84946,75631,-9315
2021-11,R&D,Software,81332,83590,2258
2021-12,R&D,Software,50841,62566,11725
2022-01,R&D,Software,68758,75180,6422
2022-02,R&D,Software,96272,91147,-5125
2022-03,R&D,Software,70408,71590,1182
2022-04,R&D,Software,76849,69045,-7804
2022-05,R&D,Software,48044,45209,-2835
2022-06,R&D,Software,35997,40212,4215
2022-07,R&D,Software,43911,56676,12765
2022-08,R&D,Software,34571,34522,-49
2022-09,R&D,Software,77941,88655,10714
2022-10,R&D,Software,78712,79485,773
2022-11,R&D,Software,43387,49527,6140
2022-12,R&D,Software,33057,35557,2500
2023-01,R&D,Software,75731,90589,14858
2023-02,R&D,Software,68689,70559,1870
2023-03,R&D,Software,66486,77053,10567
2023-04,R&D,Software,49739,50256,517
2023-05,R&D,Software,23754,15478,-8276
2023-06,R&D,Software,86912,85618,-1294
2023-07,R&D,Software,28894,36931,8037
2023-08,R&D,Software,71612,67538,-4074
2023-09,R&D,Software,29496,43175,13679
2023-10,R&D,Software,49806,62469,12663
2023-11,R&D,Software,61321,75058,13737
2023-12,R&D,Software,85095,97751,12656
2024-01,R&D,Software,75147,82045,6898
2024-02,R&D,Software,58787,64250,5463
2024-03,R&D,Software,82946,94673,11727
2024-04,R&D,Software,88056,81137,-6919
2024-05,R&D,Software,54196,48163,-6033
2024-06,R&D,Software,99578,100907,1329
2024-07,R&D,Software,51656,43815,-7841
2024-08,R&D,Software,57900,66831,8931
2024-09,R&D,Software,67701,68174,473
2024-10,R&D,Software,39033,53922,14889
2024-11,R&D,Software,30805,23888,-6917
2024-12,R&D,Software,46832,54253,7421
2021-01,R&D,Travel,33944,43817,9873
2021-02,R&D,Travel,60372,74300,13928
2021-03,R&D,Travel,35379,44397,9018
2021-04,R&D,Travel,56751,48529,-8222
2021-05,R&D,Travel,25110,36683,11573
2021-06,R&D,Travel,32087,45849,13762
2021-07,R&D,Travel,29596,24847,-4749
2021-08,R&D,Travel,38313,43184,4871
2021-09,R&D,Travel,86549,93159,6610
2021-10,R&D,Travel,43705,35533,-8172
2021-11,R&D,Travel,93445,89033,-4412
2021-12,R&D,Travel,98645,90668,-7977
2022-01,R&D,Travel,79796,84333,4537
2022-02,R&D,Travel,84429,80320,-4109
2022-03,R&D,Travel,81627,72707,-8920
2022-04,R&D,Travel,57804,63183,5379
2022-05,R&D,Travel,79664,80486,822
2022-06,R&D,Travel,88099,81391,-6708
2022-07,R&D,Travel,89122,95209,6087
2022-08,R&D,Travel,68868,79683,10815
2022-09,R&D,Travel,43225,39868,-3357
2022-10,R&D,Travel,56727,57732,1005
2022-11,R&D,Travel,85697,91726,6029
2022-12,R&D,Travel,34226,35380,1154
2023-01,R&D,Travel,88926,84923,-4003
2023-02,R&D,Travel,75506,78199,2693
2023-03,R&D,Travel,69815,69139,-676
2023-04,R&D,Travel,82539,73080,-9459
2023-05,R&D,Travel,41817,36910,-4907
2023-06,R&D,Travel,33428,34594,1166
2023-07,R&D,Travel,30258,36302,6044
2023-08,R&D,Travel,25469,21725,-3744
2023-09,R&D,Travel,96256,87425,-8831
2023-10,R&D,Travel,21651,29171,7520
2023-11,R&D,Travel,45051,44569,-482
2023-12,R&D,Travel,36184,27203,-8981
2024-01,R&D,Travel,41621,41649,28
2024-02,R&D,Travel,97984,100469,2485
2024-03,R&D,Travel,54051,61094,7043
2024-04,R&D,Travel,50447,58841,8394
2024-05,R&D,Travel,50254,58763,8509
2024-06,R&D,Travel,77418,83648,6230
2024-07,R&D,Travel,34472,37361,2889
2024-08,R&D,Travel,23471,22499,-972
2024-09,R&D,Travel,28329,20426,-7903
2024-10,R&D,Travel,66850,78302,11452
2024-11,R&D,Travel,26397,19154,-7243
2024-12,R&D,Travel,73072,87642,14570
2021-01,R&D,Training,43284,51117,7833
2021-02,R&D,Training,45122,40139,-4983
2021-03,R&D,Training,82812,80811,-2001
2021-04,R&D,Training,42436,42631,195
2021-05,R&D,Training,22096,27529,5433
2021-06,R&D,Training,45279,58067,12788
2021-07,R&D,Training,46201,55916,9715
2021-08,R&D,Training,49309,54387,5078
2021-09,R&D,Training,76614,71719,-4895
2021-10,R&D,Training,22839,16223,-6616
2021-11,R&D,Training,63619,63672,53
2021-12,R&D,Training,33493,40562,7069
2022-01,R&D,Training,27531,21814,-5717
2022-02,R&D,Training,27736,25446,-2290
2022-03,R&D,Training,87155,91130,3975
2022-04,R&D,Training,82424,85259,2835
2022-05,R&D,Training,43252,48513,5261
2022-06,R&D,Training,21431,20498,-933
2022-07,R&D,Training,57481,57038,-443
2022-08,R&D,Training,94971,89969,-5002
2022-09,R&D,Training,20162,12136,-8026
2022-10,R&D,Training,39675,38136,-1539
2022-11,R&D,Training,37015,44304,7289
2022-12,R&D,Training,52591,44605,-7986
2023-01,R&D,Training,29833,27729,-2104
2023-02,R&D,Training,52972,59937,6965
2023-03,R&D,Training,61800,57147,-4653
2023-04,R&D,Training,79063,71706,-7357
2023-05,R&D,Training,60785,69466,8681
2023-06,R&D,Training,70026,65586,-4440
2023-07,R&D,Training,35892,40423,4531
2023-08,R&D,Training,37073,31073,-6000
2023-09,R&D,Training,50682,54971,4289
2023-10,R&D,Training,27927,33489,5562
2023-11,R&D,Training,86707,98682,11975
2023-12,R&D,Training,97454,96589,-865
2024-01,R&D,Training,85428,93261,7833
2024-02,R&D,Training,97465,90004,-7461
2024-03,R&D,Training,42669,38101,-4568
2024-04,R&D,Training,40644,49389,8745
2024-05,R&D,Training,48228,58282,10054
2024-06,R&D,Training,54521,69005,14484
2024-07,R&D,Training,46928,55250,8322
2024-08,R&D,Training,77714,90074,12360
2024-09,R&D,Training,82292,82415,123
2024-10,R&D,Training,26588,22892,-3696
2024-11,R&D,Training,27345,41604,14259
2024-12,R&D,Training,35352,25949,-9403
2021-01,R&D,Supplies,39446,31782,-7664
2021-02,R&D,Supplies,82032,81911,-121
2021-03,R&D,Supplies,27521,23692,-3829
2021-04,R&D,Supplies,43481,51955,8474
2021-05,R&D,Supplies,66760,79710,12950
2021-06,R&D,Supplies,64629,67093,2464
2021-07,R&D,Supplies,87169,95070,7901
2021-08,R&D,Supplies,98021,98870,849
2021-09,R&D,Supplies,89184,94361,5177
2021-10,R&D,Supplies,33140,41061,7921
2021-11,R&D,Supplies,34357,37725,3368
2021-12,R&D,Supplies,88673,102042,13369
2022-01,R&D,Supplies,85633,87040,1407
2022-02,R&D,Supplies,98258,101182,2924
2022-03,R&D,Supplies,89286,87821,-1465
2022-04,R&D,Supplies,77326,91813,14487
2022-05,R&D,Supplies,50651,45317,-5334
2022-06,R&D,Supplies,68777,75771,6994
2022-07,R&D,Supplies,87263,79117,-8146
2022-08,R&D,Supplies,30800,25855,-4945
2022-09,R&D,Supplies,83878,92586,8708
2022-10,R&D,Supplies,32819,32188,-631
2022-11,R&D,Supplies,83870,83153,-717
2022-12,R&D,Supplies,50573,53744,3171
2023-01,R&D,Supplies,50933,46707,-4226
2023-02,R&D,Supplies,92055,93038,983
2023-03,R&D,Supplies,38133,43072,4939
2023-04,R&D,Supplies,20781,27063,6282
2023-05,R&D,Supplies,76700,73523,-3177
2023-06,R&D,Supplies,38489,48740,10251
2023-07,R&D,Supplies,59961,71321,11360
2023-08,R&D,Supplies,49118,41231,-7887
2023-09,R&D,Supplies,42263,45828,3565
2023-10,R&D,Supplies,40354,40537,183
2023-11,R&D,Supplies,43648,51609,7961
2023-12,R&D,Supplies,61971,70629,8658
2024-01,R&D,Supplies,41253,47048,5795
2024-02,R&D,Supplies,46390,59518,13128
2024-03,R&D,Supplies,71578,75067,3489
2024-04,R&D,Supplies,52658,49510,-3148
2024-05,R&D,Supplies,22551,18962,-3589
2024-06,R&D,Supplies,81001,87392,6391
2024-07,R&D,Supplies,71707,62182,-9525
2024-08,R&D,Supplies,41800,42203,403
2024-09,R&D,Supplies,77828,75067,-2761
2024-10,R&D,Supplies,26710,38094,11384
2024-11,R&D,Supplies,41038,39116,-1922
2024-12,R&D,Supplies,87821,83044,-4777
